Adana|Adana
Adıyaman|Adiyaman
Afyon|Afyon
Ağrı|Agri
Aksaray|Aksaray
Amasya|Amasya
Ankara|Ankara
Antalya|Antalya
Ardahan|Ardahan
Artvin|Artvin
Aydın|Aydin
Balıkesir|Balikesir
Bartın|Bartin
Batman|Batman
Bayburt|Bayburt
Bilecik|Bilecik
Bingöl|Bingol
Bitlis|Bitlis
Bolu|Bolu
Burdur|Burdur
Bursa|Bursa
Çanakkale|Canakkale
Çankırı|Cankiri
Çorum|Corum
Denizli|Denizli
Diyarbakır|Diyarbakir
Düzce|Duzce
Edirne|Edirne
Elazığ|Elazig
Erzincan|Erzincan
Erzurum|Erzurum
Eskişehir|Eskisehir
Gaziantep|Gaziantep
Giresun|Giresun
Gümüşhane|Gumushane
Hakkari|Hakkari
Hatay|Hatay
Iğdır|Igdir
Isparta|Isparta
İstanbul|Istanbul
İzmir|Izmir
Kahramanmaraş|Kahramanmaras
Karabük|Karabuk
Karaman|Karaman
Kars|Kars
Kastamonu|Kastamonu
Kayseri|Kayseri
Kilis|Kilis
Kırıkkale|Kirikkale
Kırklareli|Kirklareli
Kırşehir|Kirsehir
Kocaeli|Kocaeli
Konya|Konya
Kütahya|Kutahya
Malatya|Malatya
Manisa|Manisa
Mardin|Mardin
Mersin|Mersin
Muğla|Mugla
Muş|Mus
Nevşehir|Nevsehir
Niğde|Nigde
Ordu|Ordu
Osmaniye|Osmaniye
Rize|Rize
Sakarya|Sakarya
Samsun|Samsun
Şanlıurfa|Sanliurfa
Siirt|Siirt
Sinop|Sinop
Şırnak|Sirnak
Sivas|Sivas
Tekirdağ|Tekirdag
Tokat|Tokat
Trabzon|Trabzon
Tunceli|Tunceli
Uşak|Usak
Van|Van
Yalova|Yalova
Yozgat|Yozgat
Zonguldak|Zonguldak
